11111
1CP11
10001
1C1E1
11111
11111
